4 4 4 4 4 4 4 4 4 4 4 4 4 4 4 4 4 4 4 4 4 4 4 4 4
4 0 0 0 0 0 0 0 0 0 0 0 0 0 0 0 0 0 0 0 0 0 0 0 4
4 0 0 0 0 0 0 0 0 0 0 0 0 0 0 3 0 0 0 0 0 0 0 0 4
4 0 0 0 0 0 0 0 0 0 0 0 0 0 3 3 3 3 0 0 0 0 0 0 4
4 0 0 0 0 0 0 0 0 0 0 0 0 0 0 0 3 3 0 0 0 0 0 0 4
4 0 0 1 1 0 0 0 0 0 0 0 0 0 3 3 3 3 0 0 0 0 0 0 4
4 0 1 1 1 1 0 0 0 0 0 0 2 2 2 2 2 0 0 0 0 0 0 0 4
4 0 0 0 1 1 0 0 0 0 0 0 0 2 2 2 0 0 0 0 0 0 0 0 4
4 0 0 0 0 0 0 0 0 0 0 1 0 0 2 2 2 2 3 3 0 0 0 0 4
4 0 0 0 0 0 0 0 0 0 1 1 1 1 1 2 2 2 0 0 0 0 0 0 4
4 0 0 0 0 0 0 0 0 1 1 1 1 0 0 2 2 0 0 0 0 0 0 0 4
4 0 0 0 3 0 0 0 0 0 0 0 0 0 0 0 0 0 0 0 0 0 0 0 4
4 0 0 0 3 3 0 0 0 0 0 0 0 0 0 2 2 0 0 1 1 3 0 0 4
4 0 0 3 3 3 3 0 0 0 0 0 0 0 2 2 2 2 3 1 3 3 0 0 4
4 0 0 0 0 3 0 0 0 0 0 0 0 0 0 0 0 0 0 0 3 3 0 0 4
4 0 0 0 0 0 0 0 0 0 0 0 0 0 0 0 0 0 0 0 0 0 0 0 4
4 0 0 0 0 0 0 0 0 0 0 0 0 0 0 0 0 0 0 0 0 0 0 0 4
4 0 0 0 0 0 0 0 0 0 0 0 0 0 0 0 0 0 0 0 0 0 0 0 4
4 4 4 4 4 4 4 4 4 4 4 4 4 4 4 4 4 4 4 4 4 4 4 4 4
1104 768 100 
336 192 100
3
144 144 100
864 336 100
336 672 100