4 4 4 4 4 4 4 4 4 4 4 4 4 4 4 4 4 4 4 4 4 4 4 4 4
4 0 0 0 0 0 0 0 0 0 0 0 0 0 0 0 0 0 3 3 0 0 0 0 4
4 0 0 0 0 0 0 0 0 0 0 0 0 0 0 0 0 3 3 3 0 0 0 0 4
4 0 0 0 0 0 0 0 0 0 0 0 0 0 0 0 0 1 3 0 0 0 0 0 4
4 0 0 0 0 0 0 0 0 0 0 0 0 0 0 0 1 1 1 0 0 0 0 0 4
4 0 0 3 3 0 3 0 0 0 0 0 1 1 1 1 1 1 1 0 0 0 0 0 4
4 0 0 3 3 0 3 0 0 0 0 0 1 1 1 1 1 1 0 0 0 0 0 0 4
4 0 0 3 3 3 3 0 0 0 0 0 1 1 1 1 3 3 0 0 0 0 0 0 4
4 0 0 0 3 3 3 0 0 0 0 0 0 0 0 0 3 0 0 0 0 0 0 0 4
4 0 0 0 0 0 0 0 0 0 2 2 2 0 0 0 3 2 2 0 0 0 0 0 4
4 0 0 0 0 0 0 0 0 0 2 2 2 2 0 0 0 2 2 2 0 0 0 0 4
4 0 0 0 0 0 0 0 0 0 3 2 2 2 2 2 2 2 2 2 2 0 0 0 4
4 0 0 0 0 0 0 0 0 0 3 3 3 3 3 2 2 2 2 2 2 0 0 0 4
4 0 0 0 0 0 0 0 0 0 0 0 3 3 3 2 2 2 2 0 0 0 0 0 4
4 0 0 0 0 0 3 0 0 0 0 0 0 0 0 0 0 0 0 0 0 0 0 0 4
4 0 0 0 0 0 3 3 0 0 0 0 0 0 0 0 0 0 0 0 0 0 0 0 4
4 0 0 0 0 3 3 3 3 0 0 0 0 0 0 0 0 0 0 0 0 0 0 0 4
4 0 0 0 0 0 0 0 0 0 0 0 0 0 0 0 0 0 0 0 0 0 0 0 4
4 4 4 4 4 4 4 4 4 4 4 4 4 4 4 4 4 4 4 4 4 4 4 4 4
720 768 100
240 288 100
3
144 192 100
528 336 100
672 48 100